OOOOOOOOXXXXXXXX.
OOOOOOXOXXXXXXXX.
OOOOOOXXXXXXXXXX.
OOOOXXXXXXXXXXXX.
OOOXXXXXXXXXXXXX.
OOOOOOOXXXXXXXXX.
OOOOOOOXXXXXXXXX.
OOOOOOOXXXXXXXXX.
OOOOOOOOOOXXXXXX.
OOOOOOOOOOOXXXXX.
OOOOOOOOOOXXXXXx.
OOOOOOOOOOOOXXXx.
OOOOOOOOOO.XXXXX.
.................
.................
